111111111
100111101
110111111
110001101
110001101
111000101
100010001
111011101
111111111